########################################
# #   #  #       # #                   #
# #   #  # #  ##   # ##########  # #####
# ### #    #   ### #          #  #   # #
#     ########   # ########## #  # #   #
##### #  #       # #        # ## ##### #
#          #   ### # ###### #        ###
########## #####   #      # #### ### # #
#    #     #   # ######## #    # # #   #
## # # ##### #     #    # ###    #   # #
#  # #  #    # ### # #  #   #  #   ### #
# ## #### ####   # # #  ### ## # # #   #
#  #      #  ##### # #    #    ##### ###
## #########  #    # # ## #  #     #   #
#       #  ## # #### # #  # ###### ### #
# #####     # #    # # #     #     #   #
#     # ### # #### # # ##### ### ### ###
####### # # #   #  # #     #      #    #
#       #   # #    #   ### ######## ## #
# ################## ###   #      #  # #
#                    #   ##### # ##  # #
### ################## ###     #  #  # #
#      #   #           #   ### ## #### #
######   # # ############# # # #  # ## #
#        # # #             #   #  #    #
# ######## # # ## # ## ### # # #  # ## #
# #        #    # #  # #   # # #  # #  #
# ##### #### #### # ## ##### # #  # # ##
#          #      #          #    # #  #
################################### ####