####################
# #   #  #       # #
# #   #  # #  ##   #
# ### #    #   ### #
#     ########   # #
##### #  #       # #
#          #   ### #
########## #####   #
#    #     #   # ###
## # # ##### #     #
#  # #  #    # ### #
# ## #### ####   # #
#  #      #  ##### #
## #########  #    #
#       #  ## # ####
# #####     # #    #
#     # ### # #### #
####### # # #   #  #
#       #   # #    #
# ##################